"filename", "language", "Properties", "Java", "comment", "blank", "total"
"d:\Ky 9 - 20231\GR\video-call\src\main\java\com\hedspi\gr\videocall\PartnerResponse.java", "Java", 0, 27, 0, 10, 37
"d:\Ky 9 - 20231\GR\video-call\src\main\java\com\hedspi\gr\videocall\ValidationExceptionHandler.java", "Java", 0, 22, 0, 8, 30
"d:\Ky 9 - 20231\GR\video-call\src\main\java\com\hedspi\gr\videocall\VideoCallApplication.java", "Java", 0, 9, 0, 5, 14
"d:\Ky 9 - 20231\GR\video-call\src\main\java\com\hedspi\gr\videocall\controller\ChatRoomMatchingController.java", "Java", 0, 34, 0, 7, 41
"d:\Ky 9 - 20231\GR\video-call\src\main\java\com\hedspi\gr\videocall\enums\Status.java", "Java", 0, 7, 0, 3, 10
"d:\Ky 9 - 20231\GR\video-call\src\main\java\com\hedspi\gr\videocall\model\PeerUserInfo.java", "Java", 0, 16, 0, 6, 22
"d:\Ky 9 - 20231\GR\video-call\src\main\java\com\hedspi\gr\videocall\service\ChatRoomMatchingService.java", "Java", 0, 21, 0, 6, 27
"d:\Ky 9 - 20231\GR\video-call\src\main\resources\application.properties", "Properties", 3, 0, 1, 1, 5
"d:\Ky 9 - 20231\GR\video-call\src\test\java\com\hedspi\gr\videocall\VideoCallApplicationTests.java", "Java", 0, 9, 0, 5, 14
"Total", "-", 3, 145, 1, 51, 200